J K KKK K K  KK K K  K K  KK KK K K K   K K  K K KK K KKKK  KK K K K  KK K K K   K KK K K KK  KK K J
JIIIIIIIIIIIIIIIIIIIIIIIIIIIIIIIIIIIIIIIIIIIIIIIIIIIIIIIIIIIIIIIIIIIIIIIIIIIIIIIIIIIIIIIIIIIIIIIIIIJ
J           L       L    L      L       L     L       L    L       L      L    L      L     L      J
J           L       L    L      L       L     L       L    L       L      L    L      L     L      J
J           L       L    L      L       L     L       L    L       L      L    L      L     L      J
J           L       L    L      L       L     L       L    L       L      L    L      L     L      J
J           L       L           L       L     L       L    L       L      L    L      L     L      J
J           L       L           L       L             L    L       L      L    L      L     L      J
J                   L                   L                  L       L      L           L     L      J
J                                       L                                 L                 L      J
J                                                                                                  J
J                                                                                                  J
J                                                 L                                                J
J      L                 L                        L                                                J
J      L          L      L                L       L            L       L                           J
J      L    L     L      L         L      L       L      L     L       L                           J
J      L    L     L      L    L    L      L       L      L     L       L      L                    J
J      L    L     L      L    L    L      L       L      L     L       L      L                    J
J      L    L     L      L    L    L      L       L      L     L       L      L                    J
J      L    L     L      L    L    L      L       L      L     L       L      L                    J
J      L    L     L      L    L    L      L       L      L     L       L      L        FFFFF       J
JGHGHGHGHGHGHGHGHGHGHGHGHGHGHGHGHGHGHGHGHGHGHGHGHGHGHGHGHGHGHGHGHGHGHGHGHGHGHGHGHGHGHGHGHGHGHGHGHGHJ
J K K K JJKKK  K  KJK  K  KKJK K   K JJ   KK   KJ K KJ  KK   JKKK K  KJK  J  JKK  KKK J  KKK  JK  KJ
JK K JKK K K KK JKK K K K K  KKJKKK KK  KK KJK K K KK JKK K K K KK  KKJK K K  KKJK K  KKJ  K   K KKJ
