FFFDDDDDDFDDDDDDFFDFFDDFFFDFDFFFFDFDDDDDDDDDDDDDFFFDDFFDFFFFDFDFFDDDDDDDDDDDDDDDDDDDDFFDFFFDDFFFDDFF
FEEEEEEEEEEEEDDDDFDDDDDDDDDDFDDDDDDEEEEEEEEEEEEEDFDDDDDFDDDDDDFDDEEEEEEEEEEEEEEEEEEEEDFDDDDDFDDDDDDF
F            EEEEEEEEEEEEEEEEEEEEEE             EEEEEEEEEEEEEEEEE                    EEEEEEEEEEEEEEF
F                                                                                                  F
F                                                                                                  F
F                                                                           ABBBBBBBBBBBBBC        F
F          ABBBBBBBBBBBBC                                                                          F
F                                                                                                  F
F                                                        ABBBBBBBBBBBC                             F
F                                                                                                  F
F                                                                                                  F
F                       ABBBBBBBBBBBBBBBBBBBC                                                      F
F                                                                                                  F
F                                                                                                  F
F                                                                                                  F
F                                                   ABBBBBBBBBBBBBBBBC                             F
F     ABBBBBBBBBBBBBBBBBBC                                                                         F
F                                                                                                  F
F                                                                                                  F
F                                                                                                  F
F                                                                                    FFFFF         F
FABBBBBBBBBBBBBBBBBBBBBBBBBBBBBBBBBBBBBBBBBBBBBBBBBBBBBBBBBBBBBBBBBBBBBBBBBBBBBBBBBBBBBBBBBBBBBBBBCF
F FFD  FFFD  FFFDFFF  D  F D  FFFF  D FFF  FD FFFFF DFD F FF  FFFFD  FFDDFF D FFF DFFFD FFFF  DDDF F
FD  FFD  FFFFD D   D  FDFFF  DFF D  FFF D FDF F DFF  FFD  DFFF D  FF  D FDFF   D  FF   D F  D FF D F
