PQQQQQPQQQQPQQQQQQPQQQQQQPQQQQQQPQQQQQPQQQQQQQQQQQPQQQQQQQQQQPQQQQQQQQPQQQPQQQQQQQQPQQQQQQQQQPQQQQQP
PUUUUUUUUUUUUUUUUUUUUUUUUUUUUUUUUUUUUUUUUUUUUUUUUUUUUUUUUUUUUUUUUUUUUUUUUUUUUUUUUUUUUUUUUUUUUUUUUUUP
P                                                                                                  P
P                             MNMNMNMNMNMNMNMNMN              MNMNMN                               P
P          MNMNMNMNMNMN                                                  MNMNMNMNMNMNMNMNMN        P
P                                                                                                  P
P                                                                                                  P
P                          MNMNMNMNMNMN                 MNMNMN                MNMNMNMNMNMN         P
P   MNMNMN                                                                                         P
P                                                                                                  P
P                                            MNMNMNMNMN                                            P
P                                                                                                  P
P           MNMNMNMNMNMNMNMNMN                                                                     P
P                                                  MNMNMNMNMNMNMNMNMN                              P
P                                                                                                  P
P                             MNMNMNMNMNMNMNMNMN                                                   P
P                                                                     MNMNMN                       P
P  MNMNMNMNMNMN                                                                                    P
P                          MNMNMNMNMNMNMNMNMNMNMNMNMNMNMNMNMNMN                                    P
P                                                                                                  P
P                                                                                    FFFFF         P
PMNMNMNMNMNMNMNMNMNMNMNMNMNMNMNMNMNMNMNMNMNMNMNMNMNMNMNMNMNMNMNMNMNMNMNMNMNMNMNMNMNMNMNMNMNMNMNMNMNP
PQQQQQQQQQQQQQQQQQQQQQQQQQQQQQQQQQQQQQQQQQQQQQQQQQQQQQQQQQQQQQQQQQQQQQQQQQQQQQQQQQQQQQQQQQQQQQQQQQQP
PQQQQQQQ QQQQQQQQQQQQQ QQQQQQQQQQQQQQQQQQQQQQQQQ QQQQQQQQQQQQQQQQQQQQQQQQ QQQQQQQQQQQQQQQQQQQQQQQQQP
