FHHHHHHHHHHHHHHHHHHHHHHHHHHHHHHHHHHHHHHHHHHHHHHHHHHHHHHHHHHHHHHHHHHHHHHHHHHHHHHHHHHHHHHHHHHHHHHHHHHHHHHHHHHHHHHHHHHHHHHHHHHHHHHHHHHHHHHHHHHHHHHHHHHHHHHHHHHHHHHHHHHHHHHHHHHHHHHHHHHHHHHHHHHHHHHHHHHHHHH
FEEEEEEEEEEEEEEEEEEEEEE   EEEEEEEEEEEEEEEEEEEEEEEEEEEEEEEEEEEEEEEEEEEEEEEEEEEEEEEEEEEEEEEEEEEEEEEEEEEEEE    EEEEEEEEEEEEEEEEEEEEEEEEEEEEEEEEEEEEEEEEEEEEEEEEEEEEEEEEEEEEEEEEEEEEEEEEEEEE            LLL
F  IEEEEEEEEEEEEEEJ        IEEEEEEEEEEEEEEEEEEEEEJ      IEEEEEEEEEEEEEEEEEEEEEEEEEEEEEEEEEEEEEEEEEEJ           EEEEEEEEEEEEEEEEEEEEEEEEEEEEEEEEEEEEEEEEEEEEEEEEE                EEEEEE              LLL
F    EEEEEE                     IEEEEEEEEEEEEEEEEEJ         IEEEEEEEEEEEEEEEEEEEEEEEEEEEEEEEEEEEEEEEEJ             EEEEEEEEEEEEEEEEEEEEEEEEEEEEEEEEEEEEJ                                              L
F                             IEEEEEEEEEEEEEEEJ               IEEEEEEEEEEEEEEEEEEEEEEEEEEEEEEEJ                   EEEEEEEEEEEEEEEEEEEEEEEEEEEEEEEEEJ                                                  L
F                               IEEEEEJ                           EEEEEEEEEEEE            EEE                      IEEEEEEEEEEEEEEEEEEEEEEEEEEEEEEJ                                                 LLL
F                                 EEE                               IEEEEEEJ              EEE                           EEEEE            EEEEE                                                       LL
F                                   E                                EEEEEE               EEE                           EEEEEE            EEE                                                         L
F                                   E                                EEEEEE               EEE                             EEE                                                                         L
F                                                                   EEEEEE                EEE                                                                                                         L
F                                                                      EEE                 EE                                                                                                         L
F                                                                                                                                                                                                     L
F                                                                                                                                                                                                     L
F                                                                                                                              EEEEEEEEEEEEEEEEEEEK                                                   L
F                                                                                                                                                                                                     L
F              TEEEEEEEEEEEEEEEEEEEEEJ                                                                                                                                                                L
F                  BAAAEEEEEEEEEI                                                                                                                                                                   LLL
F                                                                                                                                                                                                   LLL
F                                                                                                                                                                                                   LLL
F                                                                                                                                                                                                    LL
F                                                                                                                                                                                                    LL
F                                                                                                                                                                                                    LL
F                                                                                                                                                                                                     L
F                                                HHHHHHHHHHHHHHHHHHHHHHHHHHHHHHHHHHHHHHHHHHHHHHHHHHHJ                                                                                                 L                                                                           L
F                                                                                                                                                                                                    LL
F                                                                                                                                                                                                   LLL
F                                                                                                                                                                                                    LL
F                                                                                                                                                                                                     L
F                                                                                                                                                                                                     L
F                                                                                                                                                                                                     L
F                            FAAAAAAAAAAAAAAAAAK                                                                                                                                                      L
F                           IEEEEEEEEEEEEEEEEEEEJ                                                                                                                                                     L
F                                                                                                                                                                                                   LLL
F                                                                                                                                                                                                    LL
F                                                                                                       EEEEEEEEEE                                                                                    L
F                                                                                                      BAAAAAEEEEEEK                                                                                  L
F                                                                                                                                                                                                     L
F                                                                                                                                                                                                     L
F                                                  EEE                                              EEE                                   E EE                                                        L
F                    EE                             EE                                              EEE                                   E EE                                                        L
F                     E                             EE                                              EEEE                                  EEEE                                                      LLL
F                     E                             EE                                              EEEE                                  EEEE                                                       LL
F                    EE                             EE                                              EEEE                                  EEEEE                                                       L
F                    EE                             EE                                            EEEEEE                                 EEEEEEE                                                     LL
F                   EEE                             EE                   EEE             BAAAAAAAAAAAAAAAAAAAK                        BAAAAAAK                                                        L
F                   EEE                            EEE                  EEEE    BAAAAAAAAAEEEEEEEEEEEEEEEEEEEAK                   BAAAAAEEEEAAAAK                                                     L
F           BAAAAAAAAAAAAAAAAAAK                AAAAAAAAA             BAAAAAAAAAAAEEEEEEEEEEEEEEEEEEEEEEEEEAK                 BAAAAAAAAEEEEEEAAAAK                                                   LL
FAAAAAAAAAAAAEEEEEEEEEEEEEEAAAAAAAAAAAAA      BLLLLLLLLLLK           BAEEEEEEEEEEEEEEEEEEEEEEEEEEEEEEEEEEEEEEEEEEEEE         EEEEEEEEEEEEEEEEEEEEAK                                     ROOOOOR       L
FAAAAAAAAAAAAAAAAAAAAAAAAAAAAAAAAAAAAAAAAAAAAAAAAAAAAAAAAAAAAAAAAAAAAAAAAAAAAAAAAAAAAAAAAAAAAAAAAAAAAAAAAAAAAAAAAAAAAAAAAAAAAAAAAAAAAAAAAAAAAAAAAAAAAAAAAAAAAAAAAAAAAAAAAAAAAAAAAAAAAAAAAAAAAAAAAAAAAAA
