FFFDDDDDDFDDDDDDFFDFFDDFFFDFDFFFFDFDDDDDDDDDDDDDFFFDDFFDFFFFDFDFFDDDDDDDDDDDDDDDDDDDDFFDFFFDDFFFDFF
FEEEEEEEEEEEEDDDDFDDDDDDDDDDFDDDDDDEEEEEEEEEEEEEDFDDDDDFDDDDDDFDDEEEEEEEEEEEEEEEEEEEEDFDDDDDFDDDDDF
F            EEEEEEEEEEEEEEEEEEEEEE             EEEEEEEEEEEEEEEEE                    EEEEEEEEEEEEEE
F                                                                                                 F
F                                                                                                 F
F                                                                           ABBBBBBBBBBBBBC       F
F          ABBBBBBBBBBBBC                                                                         F
F                                                                                                 F
F                                                        ABBBBBBBBBBBC                            F
F                                                                                                 F
F                                                                                                 F
F                       ABBBBBBBBBBBBBBBBBBBC                                                     F
F                                                                                                 F
F                                                                                                 F
F                                                                                                 F
F                                                   ABBBBBBBBBBBBBBBBC                            F
F     ABBBBBBBBBBBBBBBBBBC                                                                        F
F                                                                                                 F
F                                                                                     W           F
F                                                                                                 F
F                                                                                   FFFFF         F
FABBBBBBBBBBBBBBBBBBBBBBBBBBBBBBBBBBBBBBBBBBBBBBBBBBBBBBBBBBBBBBBBBBBBBBBBBBBBBBBBBBBBBBBBBBBBBBBCF
F FFD  FFFD  FFFDFFF  D  F D  FFFF  D FFF  FD FFFFF DFD F FF  FFFFD  FFDDFF D FFF DFFFD FFFF  D F F
FD  FFD  FFFFD D   D  FDFFF  DFF D  FFF D FDF F DFF  FFD  DFFF D  FF  D FDFF   D  FF   D F  D FF DF
