QQQQQQQQQQQQQQQQQQQQQQQQQQQQQQQQQQQQQQQQQQQQQQQQQQQQQQQQQQQQQQQQQQQQQQQQQQQQQQQQQQQQQQQQQQQQQQQQQQQQQQQQQQQQQQQQQQQQQQQQQQQQQQQQQQQQQQQQQQQQQQQQQQQQQQQQQQQQQQQQQQQQQQQQQQQQQQQQQQQQQQQQQQQQQQQQQQQQQQQ
O    RQQQQNQQQQQQNQQQQ             RQQQQNQQQQP                     RQQQQQQQQNQQQQQQQQQQQQQQQQQQQQP                                          QQQQR                                                    RR
O          RQQQQQQQN                RNQQQQQP                        QQQQQQQQQQQQQQQQQQQQQQQQQQQQP                                           QQQQQR                                                   RR
O			       QQQQQ                  RQQQQQ                                                                                                 QQQQQQR                                                 RRRR
O			       RQQP                    QQQQQ                                                                                               QQQQQQQQR                                                   RR
O			         QQ                   NQQQQ                                                                                                                                                            RR
O			         QQQ                  QQP 	                                          ROOOOOGOOOGOOOOOOOGOOR			                                                                                      R
O             QQQQ                 				                                       NQQQQQQQQQQQQQQQQQQP                                                                  OOOOOOOOO                     RR
O             QQQQ                                                                                                                                                 NGGGGGGGGGGGGGGGGGQ              RRR
O              RP                                                                                                                                                                                   RRR
O                                                                                                                                                                                                   RRR
O                                                                                                                                      OGOGGGGGOOOOOGP                                               RR
O                                           NGGGGGGGGGP                                                                                 QQQRQQQQQQQRQQ                                                R
O                                                                                                                                           QQQQQQQQQR                                               RR
O                                                                                                                                                                                                    RR
O				                   	                                             RQQQQGQQQQQQQGQQQQQQQQQQQQQQN                                                                                               RR
O				                                                     	             ROOOOOOOOOOOOOOOO                                                                                                          R
O                                                                                                                                                                                                     R
O                                                                                                                       GG                                        NOOOOOOOOOOOOOOOOOOOOOOP          RRR
O                                                                                                                       NNN                                      GGGGGGGGGGGGGGGGGGGGGGGGGGGGGGGGGG  RR
O                                                   OQQQN                                                               NNN                                                                          RR
O		                                       OOOOOOOOOOOOOOOOOOOOOOOOOOO                                               GOOGONROP                                                                        R
O                                          ROOOOOOOOOOOOOOGOOOOOOOOOP                                                                                                                                RR
O                                                                                                                                                                                                   RRR
O                                                                                                                                                                                                   RRR
O                                                                                                                                                                                                    RR
O                                                                                                                                                         GGGGGGGGGGGGGGGGGGGGGGGGGGGGGGGGG           R
O                                                                                                                                                              NQQQQQQQQQQQQQQQQQQQQQQQQQR            R
O                                                                                                                                                                                                    RR
O              OOOGOOOOOOGOOOOOOOOOOGOOOOOOOOOGOOOOOOOOOOOOOOOOOOOGOOOOOOOOOOO                                                                                                                       RR
O              QQQQQQQQQQQQQQQQQQQQQQQQQQQQQQQQQQQQQQQQQQQQQQQQQQQQQQQQQQQQQQQ                                                                                                                       RR
O                                                                                                                                                                                                     R
O                                                                                                                    NOOOOOOPPPPPPPR                                                                RRR
O                                                                                                                                                                                                    RR
O                                                                                                                                                                                                     R
O                                                                                                                                                                                                     R
O                       ROOOOOOOOGOOOOOOOGOOOO                                                                                                                                                       RR
O                        NOOOOOOOOOOQQQQQQQQQQO                                                                                                                                                     RRR
O                        RNOOOOOOP                                                                                                                                                                   RR
O                           NOOOOOO                                                                                                                                                                   R
O                           NOOOOOO                                               NOOOOOOOOOOOOOOOOP                                                                                                 RR
O                           NOOOOOO                                                 QQQQQQQQQQQQQQQQQQQQQ                                                                                            RR
O                            NOOOOOO                                                                                                                                                                 RR
O                            NOOOOOO                                                                                                                                                                RRR
O                            OOOOOOO                        OOOOOOP                                                                                                                                  RR
O                           ROOOOOOOOO                                                                                                                                                                R
O                      ROOOOOOOOOOOOO                                                                                                                                                   LAAAAAC       R
QOOOOOQOOOQGOGOOQOQQQQQQOQQOOQQOOOOOOOOOOOOOQOOOOQQQGOOOGOOOOOQOOOOOOOOOOOGOOQQQOOOOGOOOOOOOQQOOOQQQGOOOOOOOOOOGOOOOQOOOOOOOOOOGOOOOOOOOOOOOOQQOOOOOOOOOGOOOOOOQOOOOOOOOOOGOOOOOOOOOOOOGOOOOOOOOOOOOOOO
OOOOOOOOOOOOOOOOOOOOOOOOOOOOOOOOOOOOOOOOOOOOOOOOOOOOOOOOOOOOOOOOOOOOOOOOOOOOOOOOOOOOOOOOOOOOOOOOOOOOOOOOOOOOOOOOOOOOOOOOOOOOOOOOOOOOOOOOOOOOOOOOOOOOOOOOOOOOOOOOOOOOOOOOOOOOOOOOOOOOOOOOOOOOOOOOOOOOOOO
